1111111111111111111111
10100C1011101110101111
1010101111111111111011
1000000P0000000CCC1111
1011101011111010111E11
1111111011101010001011
1000111011111010111011
1010101011111110111011
1110111010001010111011
1000C00C101010000C0001
1111111111111111111111