11111111111111111111111111111111111
110111000000CC001010111000010011011
1001100000CC01110000000C0C0C00CC0C1
1C0000000010000C0C0C0CC0C0C0C0C0CC1
10000001111110011111110000CC0000001
11111101111111C1C00000CCC0C0C0C0CC1
11111101111111010111111111100000101
11111101111111010111111000000111111
11P111000000CC001010111110101010111
1001100000CC0111000000C000C0C0C0CC1
1E0000000010000C0C0C0CCC0C000000001
10000001111110011111110CC00C0C0C0C1
11111101111111C1C00000C00000C00C001
11111111111111111111111111111111111