11111111111111111111111111111111
1P00000000100000000000000000001
11111111101011111111111111111101
10000000001010000000000000000001
10111111111010111111111111111111
10001CC1111010111111111100010001
10101C10000011100010000101010101
10101C10111111111011110101010101
1010101010000CCC1000000001110101
10101010100000011111011111110101
10101010111111000000000K00000101
1010001CC01000011111111111111101
1011111110101100000000000001C101
10100111101011111111111111010101
10100CC1101000000000000001010101
101010111011111111111111011101C1
100010000000000000000010000001E1
11111111111111111111111111111111