11111111111111111111111111111111
1PCCCCCCCC1CCCCCCCCCCCCCCCCCCCC1
111111111C1C11111111111111111101
1CCCCCCCCC1C1CCCCCCCCCCCCCCCCCC1
1C111111111C1C111111111111111111
1CCC1CC111101C111111111100010001
1C1C1C1CCCCC11100010000101010101
1C1C1C10111111111011110101010101
1C1C10101CCCCCCC1CCCCCCCC1110101
1C1C1010100000011111011111110101
1C1C1010111111000000000000000101
1C10001CC01000011111111111111101
1C111111101011CCCCCCCCCCCCC1C101
1C1CC111101011111111111111010101
1C1CCCC1101CCCCCCCCCCCCCC1010101
1C1C1C111011111111111111011101C1
10001CCCCCCCCCCCCCCCCCCCCCCCC1E1
11111111111111111111111111111111