1111111111111111111111111111
10E010C000000000000000000001
1000111000000000000000000001
1P000000000000000000C0000001
10000000000000000000K0000001
100C000000000000000000000001
1111111111111111111111111111