1111111111111111111111111111
10E010C000000000000000000001
10001110000000000000K0000001
1P00000000000000000000000001
1000000000000000000000000001
100C000000000000000000000001
1111111111111111111111111111