111111111111111111111111
110111000000CC0010101111
100000000000011100000001
1C000000E000000C0C0C0CC1
100000000000000001111101
11111101111111C1000000C1
111111011111110101111111
111111011111110101111111
11P111000000CC0010101111
1001100000CC0111000000C1
100000000000000C0C0C0CC1
100000011111110111111101
11111101111111C1C00000C1
111111111111111111111111