111111111111111111111111
110111000000CC0010101111
1001100000CC0111000000C1
1C0000000010000C0C0C0CC1
100000011111100111111101
11111101111111C1C00000C1
111111011111110101111111
111111011111110101111111
11P111000000CC0010101111
1001100000CC0111000000C1
1E00000000100K0C0C0C0CC1
100000011111100111111101
11111101111111C1C00000C1
111111111111111111111111